F 255,0,0
C 255,0,255



11111111111
10000000001
10001111001
1001  11111
1001  10001
1001  1W001
1111  11111
