F 255,0,0
C 255,0,255





      11111111111111111
      10000000000000001
      10000000000000001
11111110000000001111111
10000000000000001
10000000000000001
10000000000000001
100000111000N0001
1111111 111111111
