NO ./path_to_the_north_texture
SO ./path_to_the_south_texture
EA ./path_to_the_east_texture
WE ./path_to_the_west_texture
C 255, 250, 250
F 255, 255, 255

   11111111111    
   1N001111001    
   10001  1001    
   10001111001    
   10000000001    
   11111111111    
