NO ./path_to_the_north_texture 
SO ./path_to_the_south_texture
EA ./path_to_the_east_texture
WE ./path_to_the_west_texture
C 255, 250, 250
F 255, 255, 250

1111111111
1N00000001
1000000001
1000000001
1000000001
1111111111
