F 255,0,0
C 255,0,255





      1111111111111111111111111
      1000000000000000000000001
      1000000011110000111100001
      100000001  100000  100001
      1000000011110000111100001
      1000000000000000000000001
1111111000000000111111111111111
10000000000000001
10000011110000001
1000001  10000001
10000011110000001
10000000000000001
11111111111111111
