F 255,0,0
C 255,0,255





      11111111111111111111111111111
      10000000000000000000000000001
      10000000111100001111001111001
      100000001  100001  1001  1001
      10000000111100001111001111001
      10000000000000000000000000001
11011110000000001111111111111111111
10000000000000001
10000011110000001
1000001  10000001
10000011110000001
10000000000000001
11111111111111111
