F 255,0,0
C 255,0,255



            111111
            100001
            100001
            100001
            100001
            100001
            100001
111111111111100001
1000000000000000011111111
10000000000W0000000000001
1000001111110000111110001
1000001    100001   10001
1000001111110000111110001
1000000000000000000000001
1111100000111111111111111
    1000001
    1000001
    1000001
    1000001
    1000001
    1111111
