F 200,100,0
C 225,30,0

11111111111111111
10000000000000001
10000000000000001
10000000000000001
10000000000000001
10000000000000001
11111111111111111
