F 255,0,0
C 255,0,255





      111111111111111111111
      100000000000000000001
      100000000000000000001
      100000000000000000001
111111100000000011111111111
10000000000000001
10000000000000001
11111111111111111
