NO ./path_to_the_north_textur
SO ./path_to_the_south_texture
EA ./path_to_the_east_texture
WE ./path_to_the_west_texture

C 255, 250, 250
F 255, 255, 255

111111111111
100000000001
100000000001
10000000S001
100000000001
111111111111
